1111111111
1P10000001
1010C00101
10000000E1
1111111111