11111111111111111111111111111111111111111111111111111111111111111111111
10000000000000000000000000000000000000000000000000000000000000000000001
10000000000000000000000000000000000000000000000000000000000000000000001
10000000000000000000000000000000000000000000000000000000000000000000001
10000000000000000000000000000000000000000000000000000000000000000000001
10000000000000000000000000000000000000000000000000010011111111111111111
10000000000000000000000000000000000000000000000000010000000000000000011
10000000000000000000000000000000000000000000000000011111111111111100001
10000000000000000000000000000000000000000000000000000000000000000100001
10000000000000000000000000000000000000000000000000000000000000000100001
100000001E1000000000000000000000000000000000000000000000000000000100001
10000000010000000000000000000000000000000000000000000000000000000100001
100000000000000000000000000000000000000000000000000000000000000001P0001
11111111111111111111111111111111111111111111011111111111111111111111111