11111111111111111111111111111111111111111111111111111111111111111111111
10000000000000000000000000000000000000000000000000000000000000000000001
10000000000000000000000000000000000000000000000000000000000000000000001
10000000000000000000000000000000000000000000000000000000000000000000001
10000000000000000000000000000000000000000000000000000000000000000000001
10000000000000000000000000000000000000000000000000011111111111111111111
1000000000000000000000000000000000000000000000000001E000000000000E00001
10000000000000000000000000000000000000000000000000011111111111111100001
10000000000000000000000000000000000000000000000000000000000000000100001
10000000000000000000000000000000000000000000000000000000000000000100001
10000000000000000000000000000000000000000000000000000000000000000100001
10000000000000000000000000000000000000000000000000000000000000000100001
100000000000000000000000000000000000000000000000000000000000000001P0001
11111111111111111111111111111111111111111111111111111111111111111111111