11111111111111111111111111111111111111111111111111111111111111111111111
10000000000000000000000000000000000000000000000000000000000000000000001
10000000000000000000000000000000000000000000000000000000000000000000001
10000000111111111111111111111111111111111111111111111110000000000000001
11000000100000000000C00000000000000000000000000000000010000000000000001
1C100000100000000000000000000000000000000000000000010011111111111111111
10000000100000001111111111111111111111111111111111110000000000000000011
10000000100000001000000000000000000000000000000000011111111111111100001
10000000100000001000000000000000000000000000000000000000000000000100001
10000000100000000000000000000000000000000000000000000000000000000100001
100000001E1000000000000000000000000000000000000000000000000000000100001
10000000010000000000000000000000000000000000000000000000000000000100001
100000000000000000000000000000000000000000000000000000000000000001000P1
11111111111111111111111111111111111111111111111111111111111111111111111