1111111111
1P00000001
1110C00101
10010000E1
1111111111