111111111111111111111111111111111111111111111111111111
100000000000000000000000000000000000000000000000000001
10P00000000000000000000000000000000000000N000000000001
100000001111111111111111111111111111000000000000000001
11000000100000000000C000000000000000010000000000000001
1C1000001000000000000000000000000010011111111111111111
100000001000000011111111111111111000000000000000000011
100000001000000010000000000000000011111111111111100001
10000000100000001000000000000000N000000000000000100001
100000001000000000000000000000000000000000000000100001
100000001E10000000000N00000000000000000000000000100001
100000000100000000000000000000000000000000000000100001
100000000000000000000000000000000000000000000000100001
111111111111111111111111111111111111111111111111111111