111111111111111111111111111111111111111111111111111111111111111
10000000C0000000000000000000000000000000000E0000000000000000001
100000000000000000000000000000000000001100000000000000000000001
1000000000000N0000000000000000000000001100000000000000000000001
1000000000000000000000000000011000000011000000000000000C0000001
100000000000000000000000000000000000001100000000000000000000001
100000000000000000000000001100001100001100000000000000000000001
100000000000000000000000000000000000001100000000001111111110001
100000000000000000000000110001100011001100000000001100000000001
100011000000000000011000110001100011001100000000001100000000001
100011000000000000011111111111111111001111111111111111111110001
100011000000000000011000000000000000000000000000000000000000001
100011000000000000011000000000000000000000000000000000000000001
100011111111111111111000000000000000000000000000000000000000001
100000000000000000000000000000000000000000000000000000000000001
1000000000000000P000000000000000000000N000000000000000000000001
100000000000000110000011000000000000000000000000000011001100001
100000000111100110000011000000000000000000000000000011001100001
100000000100000110000011000000000000000000000000000011001100001
100000111111100110000011000000000000000000000000000011001100001
100000000000000110000011000000000000000000000000000011001100001
100000000000000110000011000000000001111111000000000011001100001
101100000000000110000011000000000001100011000000000011001100001
101100000000000110000011000000000001100011000000000011001100001
101111111111111111111111111111111111111111111111111111001100001
100000000000000000000000000000000000000000000000000000000000001
100000000000000000000000000000000000000000000000000000000000001
111111111111111111111111111111111111111111111111111111111111111
