111111111111111111111111111111111111111111
100000000000000000000000000000000000000001
100000000000000000000000000000000000000001
100000001111111111111111111111111111111111
11000000100000000000C000000000000000000001
1C1000001000000000000000000000000000000001
100000001000000011111111111111111111111111
10000000100000001000000000000N000000000001
100000001000000010000000000000000000N00001
100000001000000000000000000000000000000001
100000001E100000000000N00000000N0000000001
100000000100000000000000000000000000000001
1000000000000000000000000000000000000000P1
111111111111111111111111111111111111111111