1111111111111111111111111111
1000000000000000000N00000001
1000000011111111111111000001
11000000100C0000000000000001
1C10000010000000000010010111
1000000010000000111100000011
1000000010000000100111100001
1000000010000000100000100001
100000001E100000000000100001
100000000000N0000000001000P1
1111111111111111111111111111