1111111111111
100100C0000C1
1C00000000N01
1P0011E000001
1111111111111